################################################################################
#                                                                              #
#               #                                              #               #
#               #                                              #               #
#      #######  #                                              #  #######      #
#               #                                              #               #
#               #                                              #               #
#                                                                              #
#                                                                              #
#                                   #######                                    #
#                                   #######                                    #
#                                                                              #
#                                                                              #
#               #                                              #               #
#               #                                              #               #
#      #######  #                                              #  #######      #
#               #                                              #               #
#               #                                              #               #
#                                                                              #
################################################################################
